R 1920 1080
NO ./assets/textures/xpm/BrickOv.xpm
SO ./assets/textures/xpm/BrickOv.xpm
WE ./assets/textures/xpm/CrackOver.xpm
EA ./assets/textures/xpm/CrackOver.xpm

S ./assets/sprites/xpm/cage4.xpm
C 51,53,51
F 36,85,1

1111111111111111111111111
1000000000110000000000001
1000000000110000000020001
1011000001110000000000001
1001000000000000000000001
111111111011E000011100001
1000000000110000011101111
1111011111111101110000001
1111011111111101110101001
1100000011010101110000001
1000000000000000110020001
1020000000000000110000001
1000000000000000110101001
1100000111010101111101111
1111011111110101111111111
1111111111111111111111111
