R 1200 700
NO ./assets/textures/xpm/BrickOv.xpm
SO ./assets/textures/xpm/BrickOv.xpm
WE ./assets/textures/xpm/CrackOver.xpm
EA ./assets/textures/xpm/CrackOver.xpm

S ./assets/sprites/xpm/cage4.xpm
C 36,85,1
F 51,53,51

		1111111111111111111111111
		1000000000110000000000001
		1000000000110000000200001
		1011000001110000000000001
		1001000000000000000000001
11111111101100000111000000N000001
100000000011000001110111111111111
11110111111111011100000010001
11110111111111011101010010001
11000000110101011100000000001
10002000000000001100000010001
10000000000000001101010010001
1100000111010101111101111000111
11110111 1110101 101111010001
11111111 1111111 111111111111
